# 同义词词典
# 格式：标准词=同义词1=同义词2=...
# 第一个词为标准词，查询时会将同义词替换为标准词

# 症状相关同义词
# 第一个词必须是症状词典中存在的词
发烧=发热=体温升高=高烧=低烧=烧=发高烧
头痛=头疼=脑壳疼=偏头痛=脑袋疼
头晕=眩晕=晕眩=天旋地转=头昏=脑袋晕=晕
咳嗽=咳=干咳=咳痰=咳嗽不止
腹泻=拉肚子=拉稀=泻肚=跑肚
便秘=大便干燥=排便困难=大便干结
恶心=想吐=反胃=恶心想吐
呕吐=吐=呕=吐了
失眠=睡不着=入睡困难=睡眠障碍=睡不好
疲劳=乏力=没力气=累=疲乏=疲惫=没精神
胸闷=胸口闷=憋气=喘不上气
心悸=心慌=心跳加速=心跳快
腹痛=肚子疼=肚子痛=胃疼=胃痛=肚疼
腰痛=腰疼=腰酸=腰不好
关节痛=关节疼=骨节疼=关节不好
皮疹=起疹子=出疹=长疹子
瘙痒=痒=发痒=皮肤痒
水肿=浮肿=肿=肿胀
出血=流血=出血了
鼻塞=鼻子不通=鼻子堵=鼻塞不通

# 疾病相关同义词
感冒=伤风=着凉
糖尿病=血糖高=高血糖
高血压=血压高
高血脂=血脂高
冠心病=冠状动脉粥样硬化性心脏病
肺炎=肺部感染
胃炎=胃病
肝炎=肝病
肾炎=肾病
关节炎=风湿
抑郁症=抑郁=忧郁症
焦虑症=焦虑
失眠症=睡眠障碍
贫血=血虚
中风=脑卒中=脑梗=脑溢血

# 检查相关同义词
血常规=血液检查=验血
尿常规=尿检=验尿
CT=CT检查=电脑断层
核磁=MRI=磁共振
B超=彩超=超声检查
心电图=ECG
X光=X线=拍片

# 药品相关同义词
阿司匹林=拜阿司匹灵
布洛芬=芬必得
对乙酰氨基酚=扑热息痛=泰诺
阿莫西林=青霉素类
头孢=头孢类抗生素

# 科室相关同义词
内科=大内科
外科=大外科
儿科=小儿科
妇科=妇产科
骨科=骨外科
眼科=眼睛科
耳鼻喉科=五官科
皮肤科=皮肤性病科
心内科=心血管内科
神经内科=脑科
消化内科=胃肠科
呼吸内科=肺科

